1,1,1,1,1,1,1,0,1,1,1,1,1
1,1,1,1,1,1,1,0,1,1,1,1,1
1,1,1,0,1,1,1,0,1,1,1,1,1
1,0,0,0,0,0,0,0,0,76,1,1,1
1,0,1,1,1,0,1,1,1,1,1,1,1
1,0,1,1,1,1,1,1,1,1,1,1,1
1,0,0,0,0,0,0,1,1,1,1,1,1
-
1,1,1,1,1,1,0,1,1,1,1,1,1
1,1,1,1,1,0,0,1,1,1,1,1,1
1,1,1,1,1,75,0,1,1,1,1,1,1
1,1,1,1,1,1,0,1,1,1,1,1,1
1,1,1,1,1,1,0,1,1,1,1,1,1
1,1,1,1,1,0,0,0,1,1,1,1,1
1,1,1,1,0,0,0,0,0,1,1,1,1
-
1,1,1,1,1,0,0,0,1,1,1,1,1
1,1,1,1,1,0,50,0,1,1,1,1,1
1,1,1,1,1,0,0,0,50,0,1,1,1
1,1,1,1,1,1,1,1,1,0,1,1,1
1,1,1,0,0,0,0,0,0,0,1,1,1
1,1,1,0,1,1,1,1,1,1,1,1,1
1,1,1,0,0,0,0,1,1,1,1,1,1
-
1,1,1,1,1,0,0,0,1,1,1,1,1
1,1,1,1,1,0,0,0,1,1,1,1,1
1,1,1,0,0,0,0,0,0,0,1,1,1
1,1,1,0,0,0,0,0,0,0,1,1,1
1,1,1,0,0,0,0,0,0,0,1,1,1
1,1,1,0,0,0,0,0,0,0,1,1,1
1,1,1,1,1,1,1,1,1,1,1,1,1