1,1,1,1,1,1,1,1,1,1,1,1,1
1,0,0,0,0,0,0,0,0,0,0,0,1
1,0,0,0,0,0,53,0,0,0,0,0,1
1,0,0,0,0,0,0,0,0,0,0,0,1
1,0,0,0,0,0,0,0,0,0,0,0,1
1,0,0,0,0,0,0,0,0,0,0,0,1
1,0,0,0,0,0,0,0,0,0,0,0,1
-
1,0,0,0,0,0,0,1,0,0,0,0,1
1,1,1,1,0,0,0,0,1,0,50,0,1
1,1,1,1,1,0,51,0,0,1,0,0,1
1,1,1,1,0,0,1,0,0,0,0,1,1
1,50,0,0,0,1,0,0,1,0,0,0,1
1,52,0,51,0,0,0,1,0,0,0,0,1
1,1,0,0,1,0,0,0,1,1,0,0,1
-
1,0,1,0,51,0,0,1,0,0,0,0,1
1,0,1,1,1,0,0,0,1,52,0,0,1
1,50,1,0,1,0,1,0,0,1,0,0,1
1,1,1,1,0,0,0,0,0,0,0,1,1
1,0,1,0,0,1,0,0,1,0,0,51,1
1,0,1,51,0,1,0,1,50,0,0,1,1
1,1,1,1,0,0,0,0,1,1,0,0,1
-
1,0,0,0,0,0,0,1,0,1,0,0,1
1,0,0,1,50,0,0,52,1,1,0,0,1
1,0,0,0,1,0,1,0,1,1,0,50,1
1,1,0,1,0,0,51,0,0,1,0,1,1
1,0,0,0,0,1,1,0,1,1,51,0,1
1,0,0,51,0,1,0,1,1,1,1,0,1
1,1,0,1,0,0,0,0,1,0,0,0,1
-
1,0,0,0,1,0,0,1,0,1,0,1,1
1,0,0,0,0,0,0,1,0,0,0,0,1
1,0,0,1,0,0,1,52,0,50,0,1,1
1,0,1,0,0,0,0,1,0,1,0,0,1
1,0,0,0,0,0,0,0,1,0,0,0,1
1,1,0,0,1,1,0,1,50,0,1,0,1
1,0,0,1,0,0,0,0,1,0,1,1,1
-
1,1,1,1,1,0,0,0,1,1,1,1,1
1,0,0,0,0,0,0,0,0,0,0,0,1
1,0,0,0,0,0,0,0,0,0,0,0,1
1,0,0,0,0,0,100,0,0,0,0,0,1
1,0,0,0,0,0,0,0,0,0,0,0,1
1,0,0,0,0,0,0,0,0,0,0,0,1
1,1,1,1,1,1,1,1,1,1,1,1,1